08
25
#######>########???####??
#.....m.m......#???#..#??
#.....m*m......#####..###
#.@...mmm....../........#
#...m.......$..#####....#
#...m.......$..#####....#
#..............#???#....#
################???######
25
